111111111111111111111111111111111111111111111111111111111111
1P00000000000000000000C00000000000000000000C0000000000000001
1000111111111111111111111111C1111111111111CCCCCCCC1111110001
1000100000000000000000000000000000000C0000000000000000010001
100010111111111111111111111111111111111111111111111111010001
1000101000000000000000C0000000000000000000000000000001010001
100010101111111111111111111C11111111111111111111111101010001
1000101010000000000000000000000000000000000C0000000001010001
100010101011111111C1111111111111111111111111E111111101010001
100010101010000000000000000000000000000000000000000001010001
100010101010111111111111111111111111111111111111111101010001
100010101010100000000000000000000000000000000000000001010001
100010101010101111111111111111111111111111111111111101010001
100010101010101000000000000000000000000000000000000001010001
10001010101010101111111111111111111C111111111111111101010001
100010101010101010000000000000000000000000000000000001010001
10001010101C101010111111111111111111111111111111111101010001
10001010101010101010000000000000000000000000000000C001010001
100010101010101010101111111111111111111111111111111101010001
100010101010101010101000000000000000000000000000000001010001
100010101010101010101011111111111111111111111111111101010001
1000101010101C1010101010000000000000000000000000000001010001
1000101010101C1010101010111111111111111111111111111101010001
100010101010101010101010100000000000C00000000000000001010001
100010101010101010101010101111111111111111111111111101010001
100010101010101010101010101000000000000000000000000001010001
100010101010101C101010101010C1111111111111111111111101010001
100010101010101010101010101010000000000000000000000001010001
1C0010101010101010C0101010101010111111111111111111111101C001
1C000000000000000000000CCCCCCCCCCC00000000000000000000000C01
111111111111111111111111111111111111111111111111111111111111

