1111111111
1P00000001
1111000001
1C01000101
1011111011
1C000000E1
1111111111
